11111111111111111111111
100000000000000E0000001
100P0000000000000000001
10000000000000000000C01
100100100101C00000C0001
10000000000000100000011
10000010000000C0C000001
100C0000000000000000001
11111111111111111111111